
NO textures/glitch/a.xpm
SO textures/glitch/b.xpm
WE textures/glitch/c.xpm
EA textures/glitch/d.xpm

F 0,0,0
C 1,0,0

111111111111111
100000000000001
101111111111101
101000001000101
101001100010101
101011111110101
101010001110101
101010101110101
111110101110101
100000100000101
101111111111111
1000000000000W1
111111111111111
